10 10 7

3
1 assets/wall.png
2 assets/road.png
3 assets/apt_block.png

1 1 1 1 1 1 1 1 1 1
1 1 1 1 1 1 1 1 1 1
1 1 1 1 1 1 1 1 1 1
1 1 1 1 1 1 1 1 1 1
1 1 1 1 1 1 1 1 1 1
1 1 1 1 1 1 1 1 1 1
1 1 1 1 1 1 1 1 1 1
2 2 2 2 2 2 2 2 2 2
2 2 2 2 2 2 2 2 2 2
1 1 1 1 1 1 1 1 1 1

0 0 0 0 0 0 0 0 0 0
0 3 3 3 3 3 3 3 3 0
0 3 3 3 3 3 3 3 3 0
0 3 3 3 0 0 3 3 3 0
0 3 3 3 0 0 3 3 3 0
0 3 3 3 0 0 0 0 0 0
0 0 0 0 0 0 0 0 0 0
0 0 0 0 0 0 0 0 0 0
0 0 0 0 0 0 0 0 0 0
0 0 0 0 0 0 0 0 0 0

0 0 0 0 0 0 0 0 0 0
0 3 3 3 3 3 3 3 3 0
0 3 3 3 3 3 3 3 3 0
0 3 3 3 0 0 3 3 3 0
0 3 3 3 0 0 3 3 3 0
0 3 3 3 0 0 0 0 0 0
0 0 0 0 0 0 0 0 0 0
0 0 0 0 0 0 0 0 0 0
0 0 0 0 0 0 0 0 0 0
0 0 0 0 0 0 0 0 0 0

0 0 0 0 0 0 0 0 0 0
0 3 3 3 3 3 3 3 3 0
0 3 3 3 3 3 3 3 3 0
0 3 3 3 0 0 3 3 3 0
0 3 3 3 0 0 3 3 3 0
0 3 3 3 0 0 0 0 0 0
0 0 0 0 0 0 0 0 0 0
0 0 0 0 0 0 0 0 0 0
0 0 0 0 0 0 0 0 0 0
0 0 0 0 0 0 0 0 0 0

0 0 0 0 0 0 0 0 0 0
0 3 3 3 3 3 3 3 3 0
0 3 3 3 3 3 3 3 3 0
0 3 3 3 0 0 3 3 3 0
0 3 3 3 0 0 3 3 3 0
0 3 3 3 0 0 0 0 0 0
0 0 0 0 0 0 0 0 0 0
0 0 0 0 0 0 0 0 0 0
0 0 0 0 0 0 0 0 0 0
0 0 0 0 0 0 0 0 0 0

0 0 0 0 0 0 0 0 0 0
0 3 3 3 0 0 3 3 3 0
0 3 3 3 0 0 3 3 3 0
0 3 3 3 0 0 3 3 3 0
0 3 3 3 0 0 3 3 3 0
0 3 3 3 0 0 0 0 0 0
0 0 0 0 0 0 0 0 0 0
0 0 0 0 0 0 0 0 0 0
0 0 0 0 0 0 0 0 0 0
0 0 0 0 0 0 0 0 0 0

0 0 0 0 0 0 0 0 0 0
0 3 3 3 0 0 0 0 0 0
0 3 3 3 0 0 0 0 0 0
0 3 3 3 0 0 0 0 0 0
0 3 3 3 0 0 0 0 0 0
0 3 3 3 0 0 0 0 0 0
0 0 0 0 0 0 0 0 0 0
0 0 0 0 0 0 0 0 0 0
0 0 0 0 0 0 0 0 0 0
0 0 0 0 0 0 0 0 0 0
