20 20 4

8
1 assets/wall.png
2 assets/grass.png
3 assets/brick.png
4 assets/wood_wall.png
5 assets/north_door.png
6 assets/roof.png
7 assets/wood_ladder_wall.png
8 assets/tree.png

1 1 1 1 1 1 1 1 1 1 1 1 1 1 1 1 1 1 1 1
1 2 2 2 1 1 2 2 2 1 1 2 2 2 1 1 2 2 2 1
1 2 2 2 1 1 2 2 2 1 1 2 2 2 1 1 2 2 2 1
1 2 2 2 1 1 2 2 2 1 1 2 2 2 1 1 2 2 2 1
1 1 1 1 1 1 1 1 1 1 1 1 1 1 1 1 1 1 1 1
1 1 1 1 1 1 1 1 1 1 1 1 1 1 1 1 1 1 1 1
1 2 2 2 1 1 2 2 2 1 1 2 2 2 1 1 2 2 2 1
1 2 2 2 1 1 2 2 2 1 1 2 2 2 1 1 2 2 2 1
1 2 2 2 1 1 2 2 2 1 1 2 2 2 1 1 2 2 2 1
1 1 1 1 1 1 1 1 1 1 1 1 1 1 1 1 1 1 1 1
1 1 1 1 1 1 1 1 1 1 1 1 1 1 1 1 1 1 1 1
1 2 2 2 1 1 2 2 2 1 1 2 2 2 1 1 2 2 2 1
1 2 2 2 1 1 2 2 2 1 1 2 2 2 1 1 2 2 2 1
1 2 2 2 1 1 2 2 2 1 1 2 2 2 1 1 2 2 2 1
1 1 1 1 1 1 1 1 1 1 1 1 1 1 1 1 1 1 1 1
1 1 1 1 1 1 1 1 1 1 1 1 1 1 1 1 1 1 1 1
1 2 2 2 1 1 2 2 2 1 1 2 2 2 1 1 2 2 2 1
1 2 2 2 1 1 2 2 2 1 1 2 2 2 1 1 2 2 2 1
1 2 2 2 1 1 2 2 2 1 1 2 2 2 1 1 2 2 2 1
1 1 1 1 1 1 1 1 1 1 1 1 1 1 1 1 1 1 1 1

0 0 0 0 0 0 0 0 0 0 0 0 0 0 0 0 0 0 0 0
0 0 0 0 0 0 0 0 0 0 0 0 0 0 0 0 0 0 0 0
0 0 8 0 0 0 0 8 0 0 0 0 8 0 0 0 0 8 0 0
0 0 0 0 0 0 0 0 0 0 0 0 0 0 0 0 0 0 0 0
0 0 0 0 0 0 0 0 0 0 0 0 0 0 0 0 0 0 0 0
0 0 0 0 0 0 0 0 0 0 0 0 0 0 0 0 0 0 0 0
0 0 0 0 0 0 0 0 0 0 0 0 0 0 0 0 0 0 0 0
0 0 8 0 0 0 4 4 4 4 4 4 7 4 0 0 0 8 0 0
0 0 0 0 0 0 4 0 0 0 0 0 0 4 0 0 0 0 0 0
0 0 0 0 0 0 4 0 0 0 0 0 0 4 0 0 0 0 0 0
0 0 0 0 0 0 4 0 0 0 0 0 0 4 0 0 0 0 0 0
0 0 0 0 0 0 4 0 0 0 0 0 0 4 0 0 0 0 0 0
0 0 8 0 0 0 4 4 4 5 5 4 4 4 0 0 0 8 0 0
0 0 0 0 0 0 0 0 0 0 0 0 0 0 0 0 0 0 0 0
0 0 0 0 0 0 0 0 0 0 0 0 0 0 0 0 0 0 0 0
0 0 0 0 0 0 0 0 0 0 0 0 0 0 0 0 0 0 0 0
0 0 0 0 0 0 0 0 0 0 0 0 0 0 0 0 0 0 0 0
0 0 8 0 0 0 0 8 0 p p 0 8 0 0 0 0 8 0 0
0 0 0 0 0 0 0 0 0 0 0 0 0 0 0 0 0 0 0 0
0 0 0 0 0 0 0 0 0 0 0 0 0 0 0 0 0 0 0 0

0 0 0 0 0 0 0 0 0 0 0 0 0 0 0 0 0 0 0 0
0 0 0 0 0 0 0 0 0 0 0 0 0 0 0 0 0 0 0 0
0 0 0 0 0 0 0 0 0 0 0 0 0 0 0 0 0 0 0 0
0 0 0 0 0 0 0 0 0 0 0 0 0 0 0 0 0 0 0 0
0 0 0 0 0 0 0 0 0 0 0 0 0 0 0 0 0 0 0 0
0 0 0 0 0 0 0 0 0 0 0 0 0 0 0 0 0 0 0 0
0 0 0 0 0 0 0 0 0 0 0 0 0 0 0 0 0 0 0 0
0 0 0 0 0 0 4 4 4 4 4 4 7 4 0 0 0 0 0 0
0 0 0 0 0 0 4 0 0 0 0 0 0 4 0 0 0 0 0 0
0 0 0 0 0 0 4 0 0 0 0 0 0 4 0 0 0 0 0 0
0 0 0 0 0 0 4 0 0 0 0 0 0 4 0 0 0 0 0 0
0 0 0 0 0 0 4 0 0 0 0 0 0 4 0 0 0 0 0 0
0 0 0 0 0 0 4 4 4 4 4 4 4 4 0 0 0 0 0 0
0 0 0 0 0 0 0 0 0 0 0 0 0 0 0 0 0 0 0 0
0 0 0 0 0 0 0 0 0 0 0 0 0 0 0 0 0 0 0 0
0 0 0 0 0 0 0 0 0 0 0 0 0 0 0 0 0 0 0 0
0 0 0 0 0 0 0 0 0 0 0 0 0 0 0 0 0 0 0 0
0 0 0 0 0 0 0 0 0 0 0 0 0 0 0 0 0 0 0 0
0 0 0 0 0 0 0 0 0 0 0 0 0 0 0 0 0 0 0 0
0 0 0 0 0 0 0 0 0 0 0 0 0 0 0 0 0 0 0 0

0 0 0 0 0 0 0 0 0 0 0 0 0 0 0 0 0 0 0 0
0 0 0 0 0 0 0 0 0 0 0 0 0 0 0 0 0 0 0 0
0 0 0 0 0 0 0 0 0 0 0 0 0 0 0 0 0 0 0 0
0 0 0 0 0 0 0 0 0 0 0 0 0 0 0 0 0 0 0 0
0 0 0 0 0 0 0 0 0 0 0 0 0 0 0 0 0 0 0 0
0 0 0 0 0 0 0 0 0 0 0 0 0 0 0 0 0 0 0 0
0 0 0 0 0 0 0 0 0 0 0 0 0 0 0 0 0 0 0 0
0 0 0 0 0 0 6 6 6 6 6 6 7 6 0 0 0 0 0 0
0 0 0 0 0 0 6 6 6 6 6 6 6 6 0 0 0 0 0 0
0 0 0 0 0 0 6 6 6 6 6 6 6 6 0 0 0 0 0 0
0 0 0 0 0 0 6 6 6 6 6 6 6 6 0 0 0 0 0 0
0 0 0 0 0 0 6 6 6 6 6 6 6 6 0 0 0 0 0 0
0 0 0 0 0 0 6 6 6 6 6 6 6 6 0 0 0 0 0 0
0 0 0 0 0 0 0 0 0 0 0 0 0 0 0 0 0 0 0 0
0 0 0 0 0 0 0 0 0 0 0 0 0 0 0 0 0 0 0 0
0 0 0 0 0 0 0 0 0 0 0 0 0 0 0 0 0 0 0 0
0 0 0 0 0 0 0 0 0 0 0 0 0 0 0 0 0 0 0 0
0 0 0 0 0 0 0 0 0 0 0 0 0 0 0 0 0 0 0 0
0 0 0 0 0 0 0 0 0 0 0 0 0 0 0 0 0 0 0 0
0 0 0 0 0 0 0 0 0 0 0 0 0 0 0 0 0 0 0 0
