20 20 4

8
1 assets/wall.bmp
2 assets/grass.bmp
3 assets/brick.bmp
4 assets/wood_wall.bmp
5 assets/north_door.bmp
6 assets/roof.bmp
7 assets/wood_ladder_wall.bmp
8 assets/double.bmp

1 1 1 1 1 1 1 1 1 1 1 1 1 1 1 1 1 1 1 1
1 2 2 2 1 1 2 2 2 1 1 2 2 2 1 1 2 2 2 1
1 2 2 2 1 1 2 2 2 1 1 2 2 2 1 1 2 2 2 1
1 2 2 2 1 1 2 2 2 1 1 2 2 2 1 1 2 2 2 1
1 1 1 1 1 1 1 1 1 1 1 1 1 1 1 1 1 1 1 1
1 1 1 1 1 1 1 1 1 1 1 1 1 1 1 1 1 1 1 1
1 2 2 2 1 1 2 2 2 1 1 2 2 2 1 1 2 2 2 1
1 2 2 2 1 1 2 2 2 1 1 2 2 2 1 1 2 2 2 1
1 2 2 2 1 1 2 2 2 1 1 2 2 2 1 1 2 2 2 1
1 1 1 1 1 1 1 1 1 1 1 1 1 1 1 1 1 1 1 1
1 1 1 1 1 1 1 1 1 1 1 1 1 1 1 1 1 1 1 1
1 2 2 2 1 1 2 2 2 1 1 2 2 2 1 1 2 2 2 1
1 2 2 2 1 1 2 2 2 1 1 2 2 2 1 1 2 2 2 1
1 2 2 2 1 1 2 2 2 1 1 2 2 2 1 1 2 2 2 1
1 1 1 1 1 1 1 1 1 1 1 1 1 1 1 1 1 1 1 1
1 1 1 1 1 1 1 1 1 1 1 1 1 1 1 1 1 1 1 1
1 2 2 2 1 1 2 2 2 1 1 2 2 2 1 1 2 2 2 1
1 2 2 2 1 1 2 2 2 1 1 2 2 2 1 1 2 2 2 1
1 2 2 2 1 1 2 2 2 1 1 2 2 2 1 1 2 2 2 1
1 1 1 1 1 1 1 1 1 1 1 1 1 1 1 1 1 1 1 1

0 0 0 0 0 0 0 0 0 0 0 0 0 0 0 0 0 0 0 0
0 0 0 0 0 0 0 0 0 0 0 0 0 0 0 0 0 0 0 0
0 0 3 0 0 0 0 0 0 8 0 0 0 0 0 0 0 3 0 0
0 0 0 0 0 0 0 0 0 0 0 0 0 0 0 0 0 0 0 0
0 0 0 0 0 0 0 0 0 0 0 0 0 0 0 0 0 0 0 0
0 0 0 0 0 0 0 0 0 0 0 0 0 0 0 0 0 0 0 0
0 0 0 0 0 0 0 0 0 0 0 0 0 0 0 0 0 0 0 0
0 0 0 0 0 0 4 4 4 4 4 4 7 4 0 0 0 0 0 0
0 0 0 0 0 0 4 0 0 0 0 0 0 4 0 0 0 0 0 0
0 0 0 0 0 0 4 0 0 0 0 0 0 4 0 0 0 0 0 0
0 0 0 0 0 0 4 0 0 0 0 0 0 4 0 0 0 0 0 0
0 0 0 0 0 0 4 0 0 0 0 0 0 4 0 0 0 0 0 0
0 0 0 0 0 0 4 4 4 5 5 4 4 4 0 0 0 0 0 0
0 0 0 0 0 0 0 0 0 0 0 0 0 0 0 0 0 0 0 0
0 0 0 0 0 0 0 0 0 0 0 0 0 0 0 0 0 0 0 0
0 0 0 0 0 0 0 0 0 0 0 0 0 0 0 0 0 0 0 0
0 0 0 0 0 0 0 0 0 0 0 0 0 0 0 0 0 0 0 0
0 0 3 0 0 0 0 0 0 0 0 0 0 0 0 0 0 3 0 0
0 0 0 0 0 0 0 0 0 0 0 0 0 0 0 0 0 0 0 0
0 0 0 0 0 0 0 0 0 0 0 0 0 0 0 0 0 0 0 0

0 0 0 0 0 0 0 0 0 0 0 0 0 0 0 0 0 0 0 0
0 0 0 0 0 0 0 0 0 0 0 0 0 0 0 0 0 0 0 0
0 0 3 0 0 0 0 0 0 0 0 0 0 0 0 0 0 3 0 0
0 0 0 0 0 0 0 0 0 0 0 0 0 0 0 0 0 0 0 0
0 0 0 0 0 0 0 0 0 0 0 0 0 0 0 0 0 0 0 0
0 0 0 0 0 0 0 0 0 0 0 0 0 0 0 0 0 0 0 0
0 0 0 0 0 0 0 0 0 0 0 0 0 0 0 0 0 0 0 0
0 0 0 0 0 0 4 4 4 4 4 4 7 4 0 0 0 0 0 0
0 0 0 0 0 0 4 0 0 0 0 0 0 4 0 0 0 0 0 0
0 0 0 0 0 0 4 0 0 0 0 0 0 4 0 0 0 0 0 0
0 0 0 0 0 0 4 0 0 0 0 0 0 4 0 0 0 0 0 0
0 0 0 0 0 0 4 0 0 0 0 0 0 4 0 0 0 0 0 0
0 0 0 0 0 0 4 4 4 4 4 4 4 4 0 0 0 0 0 0
0 0 0 0 0 0 0 0 0 0 0 0 0 0 0 0 0 0 0 0
0 0 0 0 0 0 0 0 0 0 0 0 0 0 0 0 0 0 0 0
0 0 0 0 0 0 0 0 0 0 0 0 0 0 0 0 0 0 0 0
0 0 0 0 0 0 0 0 0 0 0 0 0 0 0 0 0 0 0 0
0 0 3 0 0 0 0 0 0 0 0 0 0 0 0 0 0 3 0 0
0 0 0 0 0 0 0 0 0 0 0 0 0 0 0 0 0 0 0 0
0 0 0 0 0 0 0 0 0 0 0 0 0 0 0 0 0 0 0 0

0 0 0 0 0 0 0 0 0 0 0 0 0 0 0 0 0 0 0 0
0 0 0 0 0 0 0 0 0 0 0 0 0 0 0 0 0 0 0 0
0 0 0 0 0 0 0 0 0 0 0 0 0 0 0 0 0 0 0 0
0 0 0 0 0 0 0 0 0 0 0 0 0 0 0 0 0 0 0 0
0 0 0 0 0 0 0 0 0 0 0 0 0 0 0 0 0 0 0 0
0 0 0 0 0 0 0 0 0 0 0 0 0 0 0 0 0 0 0 0
0 0 0 0 0 0 0 0 0 0 0 0 0 0 0 0 0 0 0 0
0 0 0 0 0 0 6 6 6 6 6 6 7 6 0 0 0 0 0 0
0 0 0 0 0 0 6 6 6 6 6 6 6 6 0 0 0 0 0 0
0 0 0 0 0 0 6 6 6 6 6 6 6 6 0 0 0 0 0 0
0 0 0 0 0 0 6 6 6 6 6 6 6 6 0 0 0 0 0 0
0 0 0 0 0 0 6 6 6 6 6 6 6 6 0 0 0 0 0 0
0 0 0 0 0 0 6 6 6 6 6 6 6 6 0 0 0 0 0 0
0 0 0 0 0 0 0 0 0 0 0 0 0 0 0 0 0 0 0 0
0 0 0 0 0 0 0 0 0 0 0 0 0 0 0 0 0 0 0 0
0 0 0 0 0 0 0 0 0 0 0 0 0 0 0 0 0 0 0 0
0 0 0 0 0 0 0 0 0 0 0 0 0 0 0 0 0 0 0 0
0 0 0 0 0 0 0 0 0 0 0 0 0 0 0 0 0 0 0 0
0 0 0 0 0 0 0 0 0 0 0 0 0 0 0 0 0 0 0 0
0 0 0 0 0 0 0 0 0 0 0 0 0 0 0 0 0 0 0 0
